12.ox
....o.....
.o..ooo...
o....oooo.
.........o
o...o...o.
..........
.......o..
.o.o..o.o.
.o........
....o....o
o.......o.
o.......o.
