7.ox
..ooo......o...
.....o.ooo.....
o..o...o.......
.o....o.....o.o
.....oo...o....
..o.....o.o.o..
....o..o.o.....
